
(:SIZE (80 80) 
 :TABLE (W GAME-WALL 
	 SPACE GAME-FLOOR 
	 P (PLAYER GAME-FLOOR)
	 b (bee pop-floor)
	 c (chototsu pop-floor)
	 r (red-bee pop-floor)
	 u upstairs
	 d downstairs))
w w w w w w w w w w w w w w w w w w w w w w w w w w w w w w w w w w w w w w w w w w w w w w w w w w w w w w w w w w w w w w w w w w w w w w w w w w w w w w w w 
w w w w w w w w w w w w w w w w w w w w w w w w w w w w w w w w w w w w w w w w w w w w w w w w w w w w w w w w w w w w w w w w w w w w w w w w w w w w w w w w 
w w w w w w w w w w w w w w w w w w w w w w w w w w w w w w w w w w w w w w w w w w w w w w w w w w w w w w w w w w w w w w w w w w w w w w w w w w w w w w w w 
w w w w w w w w w w w w w w w w w w w w w w w w w w w w w w w w w w w w w w w w w w w w w w w w w w w w w w w w w w w w w w w w w w w w w w w w w w w w w w w w 
w w w                                         w w w w w w w w w w w w w w w w w w w w w w w w w w w w w w w w w w w w w w w w w w w w w w w w w w w w w w w w w 
w w w                                         w w w w w w w w w w w w w w w w w w w w w w w w w w w w w w w w w w w w w w w w w w w w w w w w w w w w w w w w w 
w w w                                         w w w w w w w w w w w w w w w w w w w w w w                                                               w w w w 
w w w                                         w w w w w w w w w w w w w w w w w w w w w w                                                               w w w w 
w w w                                         w w w w w w w w w w w w w w w w w w w w w w                                                               w w w w 
w w w                                         w w w w w w w w w w w w w w w w w w w w w w                                                               w w w w 
w w w                                         w w w w w w w w w w w w w w w w w w w w w w                                                               w w w w 
w w w                                                                                                                                                   w w w w 
w w w                                                                                                                                                   w w w w 
w w w                                                                                                                                                   w w w w 
w w w                                               w w w w w w w w w w w w w w w w w w w                                                               w w w w 
w w w                                               w w w w w w w w w w w w w w w w w w w                                                               w w w w 
w w w                                               w w w w w w w w w w w w w w w w                                                                     w w w w 
w w w                                               w w w w w w w w w w w w w w w w                                                               w w w w w w w 
w w w                                               w w w w w w w w w w w w w w w w                                                               w w w w w w w 
w w w                                               w w w w w w w w w w w w w w w w       w w w w w w w w w w w w w w w w w w w w w w w w w       w w w w w w w 
w w w                                               w w w w w w w w w w w w w w w w       w w w w w w w w w w w w w w w w w w w w w w w w w       w w w w w w w 
w w w                                               w w w w w w w w w w w w w w w w       w w w w w w w w w w w w w w w w w w w w w w w w w       w w w w w w w 
w w w                                         w w w w w w w w w w w w w w w w w w w       w w w w w w w w w w w w w w w w w w w w w w w w w       w w w w w w w 
w w w                   d                     w w w w w w w w w w w w w w w w w w w       w w w w w w w w w w w w w w w w w w w w w w w w w       w w w w w w w 
w w w                                         w w w w w w w w w w w w w w w w w w w       w w w w w w w w w w w w w w w w w w w w w w                         w 
w w w                                         w w w w w w w w w w w w w w w w w w w       w w w w w w w w w w w w w w w w w w w w w w                         w 
w w w                                         w w w w w w w w w w w w w w w w w w w       w w w w w w w w w w w w w w w w w w w w w w                         w 
w w w                                         w w w w w w w w w w w w w w w w w w w       w w w w w w w w w w w w w w w w w w w w w w                         w 
w w w                                               w w w w w w w w w w w w w w w w       w w w w w w w w w w w w w w w w w w w w w w                         w 
w w w                                               w w w w w w w w w w w w w w w                                                 w w                         w 
w w w                                                                                                                             w w                         w 
w w w                                                                                                                             w w                         w 
w w w                                                                                                                 w w w       w w                         w 
w w w                                         w w w w w w w w w w w w w w w w w w                                     w w w       w w                         w 
w w w                                         w w w w w w w w w w w w w w w w w w                                     w w w       w w                         w 
w w w w w w w w w w w w w w w w w w w w w w w w w w w w w w w w w w w w w w w w w                                     w w w       w w                         w 
w w w w w w w w w w w w w w w w w w w w w w w w w w w w w w w w w w w w w w w w w                                     w w w       w w                         w 
w w w w w w w w w w w w w w w w w w w w w w w w w w w w w w w w w w w w w w w w w                                     w w w       w w                         w 
w w w w w w w w w w w w w w w w w w w w w w w w w w w w w w w w w w w w w w w w w                                     w w w       w w                         w 
w w w w w w w w w w w w w w w w w w w w w w w w w w w w w w w w w w w w w w w w w                                     w w w                                   w 
w w w w w w w w w w w w w w w w w w w w w w w w w w w w w w w w w w w w w w w w w                                     w w w                                   w 
w w w w w w w w w w w w w w w w w w w w w w w w w w w w w w w w w w w w w w w w w                                     w w w                                   w 
w w w w w w w w w w w w w w w w w w w w w w w w w w w w w w w w w w w w w w w w w                                     w w w       w w                         w 
w w w w w w w w w w w w w w w w w w w w w w w w w w w w w w w w w w w w w w w w w                                     w w w       w w                         w 
w w w w w w w w w w w w w w w w w w w w w w w w w w w w w w w w w w w w w w w w w                                     w w w       w w                         w 
w w w w w w w w w w w w w w w w w w w w w w w w w w w w w w w w w w w w w w w w w                                     w w w       w w w w       w w w w w w w w 
w w w w w w w w w w w w w w w w w w w w w w w w w w w w w w w w w w w w w w w w w                                     w w w       w w w w       w w w w w w w w 
w w w w w w w w w w w w w w w w w w w w w w w w w w w w w w w w w w w w w w w w w                                                 w w w w       w w w w w w w w 
w w w w w w w w w w w w w w w w w w w w w w w w w w w w w w w w w w w w w w w w w                                                 w w w w       w w w w w w w w 
w w w w w w w w w w w w w w w w w w w w w w w w w w w w w w w w w w w w w w w w w                                                 w w w w       w w w w w w w w 
w w w w w w w w w w w w w w w w w w w w w w w w w w w w w w w w w w w w w w w w w                                     w w w       w w w w                     w 
w w w w w w w w w w w w w w w w w w w w w w w w w w w w w w w w w w w w w w w w w                                     w w w       w w w w                     w 
w w w w w w w w w w w w w w w w w w w w w w w w w w w w w w w w w w w w w w w w w                    pu               w w w       w w w w                     w 
w w w w w w w w w w w w w w w w w w w w w w w w w w w w w w w w w w w w w w w w w                                     w w w       w w w w w w w w w w w       w 
w w w w w w w w w w w w w w w w w w w w w w w w w w w w w w w w w w w w w w w w w                                     w w w       w w w w w w w w w w w       w 
w w w w w w w w w w w w w w w w w w w w w w w w w w w w w w w w w w w w w w w w w                                     w w w       w w w w w w w w w w w       w 
w w w w w w w w w w w w w w w w w w w w w w w w w w w w w w w w w w w w w w w w w                                     w w w       w w w w w w w w w w w       w 
w w w w w w w w w w w w w w w w w w w w w w w w w w w w w w w w w w w w w w w w w                                     w w w                                   w 
w w w w w w w w w w w w w w w w w w w w w w w w w w w w w w w w w w w w w w w w w                                     w w w                                   w 
w w w w w w w w w w w w w w w w w w w w w w w w w w w w w w w w w w w w w w w w w                                     w w w                                   w 
w w w w w w w w w w w w w w w w w w w w w w w w w w w w w w w w w w w w w w w w w w w w w w w w w w w w w w w w w w w w w w                                   w 
w w w w w w w w w w w w w w w w w w w w w w w w w w w w w w w w w w w w w w w w w w w w w w w w w w w w w w w w w w w w w w                                   w 
w w w w w w w w w w w w w w w w w w w w w w w w w w w w w w w w w w w w w w w w w w w w w w w w w w w w w w w w w w w w w w                                   w 
w w w w w w w w w w w w w w w w w w w w w w w w w w w w w w w w w w w w w w w w w w w w w w w w w w w w w w w w w w w w w w                                   w 
w w w w w w w w w w w w w w w w w w w w w w w w w w w w w w w w w w w w w w w w w w w w w w w w w w w w w w w w w w w w w w                                   w 
w w w w w w w w w w w w w w w w w w w w w w w w w w w w w w w w w w w w w w w w w w w w w w w w w w w w w w w w w w w w w w                                   w 
w w w w w w w w w w w w w w w w w w w w w w w w w w w w w w w w w w w w w w w w w w w w w w w w w w w w w w w w w w w w w w                                   w 
w w w w w w w w w w w w w w w w w w w w w w w w w w w w w w w w w w w w w w w w w w w w w w w w w w w w w w w w w w w w w w                                   w 
w w w w w w w w w w w w w w w w w w w w w w w w w w w w w w w w w w w w w w w w w w w w w w w w w w w w w w w w w w w w w w                                   w 
w w w w w w w w w w w w w w w w w w w w w w w w w w w w w w w w w w w w w w w w w w w w w w w w w w w w w w w w w w w w w w                                   w 
w w w w w w w w w w w w w w w w w w w w w w w w w w w w w w w w w w w w w w w w w w w w w w w w w w w w w w w w w w w w w w w w w                             w 
w w w w w w w w w w w w w w w w w w w w w w w w w w w w w w w w w w w w w w w w w w w w w w w w w w w w w w w w w w w w w w w w w                             w 
w w w w w w w w w w w w w w w w w w w w w w w w w w w w w w w w w w w w w w w w w w w w w w w w w w w w w w w w w w w w w w w w w                             w 
w w w w w w w w w w w w w w w w w w w w w w w w w w w w w w w w w w w w w w w w w w w w w w w w w w w w w w w w w w w w w w w w w                             w 
w w w w w w w w w w w w w w w w w w w w w w w w w w w w w w w w w w w w w w w w w w w w w w w w w w w w w w w w w w w w w w w w w                             w 
w w w w w w w w w w w w w w w w w w w w w w w w w w w w w w w w w w w w w w w w w w w w w w w w w w w w w w w w w w w w w w w w w                             w 
w w w w w w w w w w w w w w w w w w w w w w w w w w w w w w w w w w w w w w w w w w w w w w w w w w w w w w w w w w w w w w w w w                             w 
w w w w w w w w w w w w w w w w w w w w w w w w w w w w w w w w w w w w w w w w w w w w w w w w w w w w w w w w w w w w w w w w w w w w w w w w w w w w w w w w 
w w w w w w w w w w w w w w w w w w w w w w w w w w w w w w w w w w w w w w w w w w w w w w w w w w w w w w w w w w w w w w w w w w w w w w w w w w w w w w w w 
w w w w w w w w w w w w w w w w w w w w w w w w w w w w w w w w w w w w w w w w w w w w w w w w w w w w w w w w w w w w w w w w w w w w w w w w w w w w w w w w 
