(:SIZE (60 60) 
 :TABLE (W GAME-WALL 
  	SPACE GAME-FLOOR 
        P (PLAYER GAME-FLOOR)
        b (bee pop-floor)
	c (chototsu pop-floor)
	d downstairs))
w w w w w w w w w w w w w w w w w w w w w w w w w w w w w w w w w w w w w w w w w w w w w w w w w w w w w w w w w w w w 
w w w w w w w w w w w w w w w w w w w w w w w w w w w w w w w w w w w w w w w w w w w w w w w w w w w w w w w w w w w w 
w w w w w w w w w w w w w w w w w w w w w w w w w w w w w w w w w w w w w w w w w w w w w w w w w w w w w w w w w w w w 
w w w w w w w w w w w w w w w w w w w w w w w w w w w w w w w w w w w w w w w w w w w w w w w w w w w w w w w w w w w w 
w w w w w w w w w w w w w w w w w w w w w w w w w w w w w w w w w w w w w w w w w w w w w w w w w w w w w w w w w w w w 
w w w w w w w w w w w w w w w w w w w w w w w w w w w w w w w w w w w w w w w w w w w w w w w w w w w w w w w w w w w w 
w w w w w w w w w w w w w w w w w w w w w w w w w w w w w w w w w w w w w w w w w w w w w w w w w w w w w w w w w w w w 
w w w w w w w w w w w w w w w w w w w w w w w w w w w w w w w w w w w w w w w w w w w w w w w w w w w w w w w w w w w w 
w w w w w w w w w w w w w w w w w w w w w w w                             w w w w w w w w w w w w w w w w w w w w w w w 
w w w w w w w w w w w w w w w w w w w w w w w                             w w w w w w w w w w w w w w w w w w w w w w w 
w w w w w w w w w w w w w w w w w w w w w w w                             w w w w w w w w w w w w w w w w w w w w w w w 
w w w w w w w w w w w w w w w w w w w w w w w                             w w w w w w w w w w w w w w w w w w w w w w w 
w w w w w w w w w w w w w w w w w w w w w w w                             w w w w w w w w w w w w w w w w w w w w w w w 
w w w w w w w w w w w w w w w w w w w w w w w                             w w w w w w w w w w w w w w w w w w w w w w w 
w w w w w w w w w w w w w w w w w w w w w w w             p               w w w w w w w w w w w w w w w w w w w w w w w 
w w w w w w w w w w w w w w w w w w w w w w w                             w w w w w w w w w w w w w w w w w w w w w w w 
w w w w w w w w w w w w w w w w w w w w w w w                             w w w w w w w w w w w w w w w w w w w w w w w 
w w w w w w w w w w w w w w w w w w w w w w w                             w w w w w w w w w w w w w w w w w w w w w w w 
w w w w w w w w w w w w w w w w w w w w w w w                             w w w w w w w w w w w w w w w w w w w w w w w 
w w w w w w w w w w w w w w w w w w w w w w w       w w w w w w w w       w w w w w w w w w w w w w w w w w w w w w w w 
w w w w w w w w w w w w w w w w w w w w w w w       w w w w w w w w       w w w w w w w w w w w w w w w w w w w w w w w 
w w w w w w w w w w w w w w w w w w w w w w w       w w w w w w w w       w w w w w w w w w w w w w w w w w w w w w w w 
w w w w w w w w w w                                                                       w w w w w w w w w w w w w w w 
w w w w w w w w w w                                                                       w w w w w w w w w w w w w w w 
w w w w w w w w w w                                                                       w w w w w w w w w w w w w w w 
w w w w w w w w w w       w w w w w w w w w w w w w w w w w w w w w w w w w w w w w       w w w w w w w w w w w w w w w 
w w w w w w w w w w                                                 w w w w w w w w       w w w w w w w w w w w w w w w 
w w w w w w w w w w                                                               w       w w w w w w w w w w w w w w w 
w w w w w w w w w w                                                                                           w w w w w 
w w w w w w w w w w                                                                                           w w w w w 
w w w w w w w w w w                                           c         w w w             c                   w w w w w 
w w w w w w w w w w                                                     w w w                                 w w w w w 
w w w w w w w w w w                                                     w w w                                 w w w w w 
w w w w w w w w w w                                                     w w w                                 w w w w w 
w w w w w w w w w w           c                                         w w w                                 w w w w w 
w w w w w w w w w w                                                     w w w                   c             w w w w w 
w w w w w w w w w w                                                     w w w                                 w w w w w 
w w w w w w w w w w                                                     w w w                                 w w w w w 
w w w w w w w w w w                                                     w w w                                 w w w w w 
w w w w w w w w w w                                                     w w w w w                   w w w w w w w w w w 
w w w w w w w w w w                                                     w w w w w                   w w w w w w w w w w 
w w w w w w w w w w                                                     w w w w w                   w w w w w w w w w w 
w w w w w w w w w w                                           c         w w w w w       w w w w w w w w w w w w w w w w 
w w w w w w w w w w                                                     w w w w w       w w w w w w w w w w w w w w w w 
w w w w w w w w w w                                                     w w w w w       w w w w w w w w w w w w w w w w 
w w w w w w w w w w                                                     w w w w w       w w w w w w w w w w w w w w w w 
w w w w w w w w w w                                                     w w w w w       w w w w w w w w w w w w w w w w 
w w w w w w w w w w                                                     w w                               w w w w w w w 
w w w w w w w w w w                                                     w w                               w w w w w w w 
w w w w w w w w w w                   c                                 w w                               w w w w w w w 
w w w w w w w w w w                                                     w w             c                 w w w w w w w 
w w w w w w w w w w                                                     w w                               w w w w w w w 
w w w w w w w w w w                                                     w w                               w w w w w w w 
w w w w w w w w w w                                                     w w                               w w w w w w w 
w w w w w w w w w w w w w w w w w w w w w w w w w w w w w w w w w       w w                               w w w w w w w 
w w w w w w w w w w w w w w w w w w w w w w w w w w w w w w w w w                               d         w w w w w w w 
w w w w w w w w w w w w w w w w w w w w w w w w w w w w w w w w w                                         w w w w w w w 
w w w w w w w w w w w w w w w w w w w w w w w w w w w w w w w w w                                         w w w w w w w 
w w w w w w w w w w w w w w w w w w w w w w w w w w w w w w w w w w w w w w                               w w w w w w w 
w w w w w w w w w w w w w w w w w w w w w w w w w w w w w w w w w w w w w w w w w w w w w w w w w w w w w w w w w w w w 
