
(:SIZE (90 90) :TABLE (W GAME-WALL SPACE GAME-FLOOR P (PLAYER GAME-FLOOR))) 
w w w w w w w w w w w w w w w w w w w w w w w w w w w w w w w w w w w w w w w w w w w w w w w w w w w w w w w w w w w w w w w w w w w w w w w w w w w w w w w w w w w w w w w w w w 
w w w w w w w w w w w w w w w w w w w w w w w w w w w w w w w w w w w w w w w w w w w w w w w w w w w w w w w w w w w w w w w w w w w w w w w w w w w w w w w w w w w w w w w w w w 
w w w w w w w w w w w w w w w w w w w w w w w w w w w w w w w w w w w w w w w w w w w w w w w w w w w w w w w w w w w w w w w w w w w w w w w w w w w w w w w w w w w w w w w w w w 
w w w w w w w w w w w w w w w w w w w w w w w w w w w w w w                                                               w w w w w w w w w w w w w w w w w w w w w w w w w w w w w 
w w w w w w w w w w w w w                                                                                                 w w w w w w w w w w w w w w w w w w w w w w w w w w w w w 
w w w w w w w w w w w w w                                                                                                 w w w w w w w w w w w w w w w w w w w w w w w w w w w w w 
w w w w w w w w w w w w w                                                                                                 w w w w w w w w w w w w w w w w w w w w w w w w w w w w w 
w w w w w w w w w w w w w       w w w w w w w w w w w w w w                                                               w w w w w w w w w w w w w w w w w w w w w w w w w w w w w 
w w w w w w w w w w w w w       w w w w w w w w w w w w w w                                                               w w w w w w w w w w w w w w w w w w w w w w w w w w w w w 
w w w w w w w w w w w w w       w w w w w w w w w w w w w w                                                               w w w w w w w w w w w w w w w w w w w w w w w w w w w w w 
w w w w w w w w w w w w w       w w w w w w w w w w w w w w                                                               w w w w w w w w w w w w w w w w w w w w w w w w w w w w w 
w w w w w w w w w w w w w       w w w w w w w w w w w w w w                                                               w w w w w w w w w w w w w w w w w w w w w w w w w w w w w 
w w w w w w w w w w w w w       w w w w w w w w w w w w w w                                                               w w w w w w w w w w w w w w w w w w w w w w w w w w w w w 
w w w w w w w w w w w w w       w w w w w w w w w w w w w w                                                               w w w w w w w w w w w w w w w w w w w w w w w w w w w w w 
w w w w w w w w w w w w w       w w w w w w w w w w w w w w                                                               w w w w w w w w w w w w w w w w w w w w w w w w w w w w w 
w w w w w w w w w w w w w       w w w w w w w w w w w w w w                                                               w w w w w w w w w w w w w w w w w w w w w w w w w w w w w 
w w w w w w w w w w w w w       w w w w w w w w w w w w w w                                                               w w w w w w w w w w w w w w w w w w w w w w w w w w w w w 
w w w w w w w w w w w w w       w w w w w w w w w w w w w w                                                               w w w w w w w w w w w w w w w w w w w w w w w w w w w w w 
w w w w w w w w w w w w w       w w w w w w w w w w w w w w                                                               w w w w w w w w w w w w w w w w w w w w w w w w w w w w w 
w w w w w w w w w w w w w       w w w w w w w w w w w w w w                                                               w w w w w w w w w w w w w w w w w w w w w w w w w w w w w 
w w w w w w w w w w w w w       w w w w w w w w w w w w w w                                                               w w w w w w w w w w w w w w w w w w w w w w w w w w w w w 
w w w w w w w w w w w w w       w w w w w w w w w w w w w w                                                               w w w w w w w w w w w w w w w w w w w w w w w w w w w w w 
w w w w w w w w w w w w w       w w w w w w w w w w w w w w                                                               w w w w w w w w w w w w w w w w w w w w w w w w w w w w w 
w w w                           w w w w w w w w w w w w w w                                                               w w w w w w w w w w w w w w w w w w w w w w w w w w w w w 
w w w                           w w w w w w w w w w w w w w                                                               w w w w w w w w w w w w w w w w w w w w w w w w w w w w w 
w w w                           w w w w w w w w w w w w w w                                                               w w w w w w w w w w w w w w w w w w w w w w w w w w w w w 
w w w                           w w w w w w w w w w w w w w                                                               w w w w w w w w w w w w w w w w w w w w w w w w w w w w w 
w w w                           w w w w w w w w w w w w w w w w w       w w w w w w       w w w w w w w w w w w w w w w w w w w w w w w w w w w w w w w w w w w w w w w w w w w w w 
w w w                           w w w w w w w w w w w w w w w w w       w w w w w w       w w w w w w w w w w w w w w w w w w w w w w w w w w w w w w w w w w w w w w w w w w w w w 
w w w                           w w w w w w w w w w w w w w w w w       w w w w w w       w w w w w w w w w w w w w w w w w w w w w w w w w w w w w w w w w w w w w w w w w w w w w 
w w w                           w w w w w w w w w w w w w w w w w       w w w w w w       w w w w w w w w w w w w w w w w w w w w w w w w w w w w w w w w w w w w w w w w w w w w w 
w w w                           w w w w w w                             w w w w w w                                                   w w w w w w w w w w w w w w w w w w w w w w w 
w w w                           w w w w w w                             w w w w w w                                                   w w w w w w w w w w w w w w w w w w w w w w w 
w w w                           w w w w w w                             w w w w w w                                                   w w w w w w w w w w w w w w w w w w w w w w w 
w w w                           w w w w w w       w w w w w w w w w w w w w w w w w w w w w w w w w w w w w w w w w w w w w w w       w w w w w w w w w w w w w w w w w w w w w w w 
w w w                           w w w w w w       w w w w w w w w w w w w w w w w w w w w w w w w w w w w w w w w w w w w w w w       w w w w w w w w w w w w w w w w w w w w w w w 
w w w                           w w w w w w       w w w w w w w w w w w w w w w w w w w w w w w w w w w w w w w w w w w w w w w       w w w w w w w w w w w w w w w w w w w w w w w 
w w w          pu               w w w w w w       w w w w w w w w w w w w w w w w w w w w w w w                                                               w w w w w w w w w w w 
w w w                           w w w w w w       w w w w w w w w w w w w w w w w w w w w w w w                                                               w w w w w w w w w w w 
w w w                           w w w w w w       w w w w w w w w w w w w w w w w w w w w w w w                                                               w w w w w w w w w w w 
w w w                           w w w w w w       w w w w w w w w w                                                                                           w w w w w w w w w w w 
w w w                           w w w w w w       w w w w w w w w w                                                                                           w w w w w w w w w w w 
w w w                                                         w w w                                                                                           w w w w w w w w w w w 
w w w                                                         w w w       w w w w w w w w w w w                                                               w w w w w w w w w w w 
w w w                                                                     w w w w w w w w w w w                                                               w w w w w w w w w w w 
w w w                           w w w                                     w w w w w w w w w w w                                                               w w w w w w w w w w w 
w w w                           w w w                                     w w w w w w w w w w w                                                               w w w w w w w w w w w 
w w w                           w w w                         w w w       w w w w w w w w w w w                                                               w w w w w w w w w w w 
w w w                           w w w                         w w w       w w w w w w w w w w w                                                               w w w w w w w w w w w 
w w w                           w w w                         w w w       w w w w w w w w w w w                                                               w w w w w w w w w w w 
w w w                       w w w w w                                     w w w w w w w w w w w                                                               w w w w w w w w w w w 
w w w                       w w w w w                                     w w w w w w w w w w w                                                               w w w w w w w w w w w 
w w w                       w w w w w                                     w w w w w w w w w w w w w w w w w w w                     w w w                     w w w w w w w w w w w 
w w w                       w w w w w                         w w w       w w w w w w w w w w w w w w w w w w w                     w w w                     w w w w w w w w w w w 
w w w w w w w w w w w w w w w w w w w                         w w w       w w w w w w w w w w w w w w w w w w w                     w w w                     w w w w w w w w w w w 
w w w w w w w w w w w w w w w w w w w                         w w w       w w w w w w w w w w w w w w w w w w w       w w w w w w w w w w w w w w w w w                           w 
w w w w w w w w w w w w w w w w w w w                         w w w       w w w w w w w w w w w w w w w w                               w w w w w w w w                           w 
w w w w w w w w w w w w w w w w w w w                         w w w       w w w w w w w w w w w w w w w w                               w w w w w w w w w                         w 
w w w w w w w w w w w w w w w w w w w                         w w w       w w w w w w w w w w w w w w w w                               w w w w w                                 w 
w w w w w w w w w w w w w w w w w w w                         w w w       w w w w w w w w w w w w w w w w                               w w w w w                                 w 
w w w w w w w w w w w w w w w w w w w                         w w w       w w w w w w w w w w w w w w w w                               w w w w w                                 w 
w w w w w w w w w w w w w w w w w w w                         w w w       w w w w w w w w w w w w w w w w                               w w w w w       w                         w 
w w w w w w w w w w w w w w w w w w w                         w w w       w w w w w w w w w w w w w w w w                               w w w w w       w                         w 
w w w w w w w w w w w w w w w w w w w                         w w w       w w w w w w w w w w w w w w w w                               w w w w w       w                         w 
w w w w w w w w w w w w w w w w w w w                         w w w       w w w w w w w w w w w w w w w w                               w w w w w       w                         w 
w w w w w w w w w w w w w w w w w w w                         w w w       w w w w w w w w w w w w w w w w                               w w w w w       w                         w 
w w w w w w w w w w w w w w w w w w w                         w w w       w w w w w w w w w w w w w w w w                               w w w w w       w                         w 
w w w w w w w w w w w w w w w w w w w                         w w w       w w w w w w w w w w w w w w w w                               w w w w w       w                         w 
w w w w w w w w w w w w w w w w w w w                         w w w       w w w w w w w w w w w w w w w w                               w w w w w       w                         w 
w w w w w w w w w w w w w w w w w w w                         w w w       w w w w w w w w w w w w w w w w                                               w                         w 
w w w w w w w w w w w w w w w w w w w                         w w w       w w w w w w w w w w w w w w w w                                               w                         w 
w w w w w w w w w w w w w w w w w w w                         w w w       w w w w w w w w w w w w w w w w                                               w                         w 
w w w w w w w w w w w w w w w w w w w                         w w w       w w w w w w w w w w w w w w w w                               w w w w w w w w                           w 
w w w w w w w w w w w w w w w w w w w w w w w w w w w w w w w w w w       w w w w w w w w w w w w w w w w                               w w w w w w w w                           w 
w w w w w w w w w w w w w w w w w w w w w w w w w w w w w w w w w w       w w w w w w w w w w w w w w w w                               w w w w w w w w       w w w w w w w w w w w 
w w w w w w w w w w w w w w w w w w w w w w w w w w w w w w w w w w       w w w w w w w w w w w w w w w w                               w w w w w w w w             w w w w w w w w 
w w w w w w w w w w w w w w w w w w w w w w w w w w w w w w w w w w       w w w w w w w w w w w w w w w w                                                           w w w w w w w w 
w w w w w w w w w w w w w w w w w w w w w w w w w w w w w w w w w w       w w w w w w w w w w w w w w w w                                                           w w w w w w w w 
w w w w w w w w w w w w w w w w w w w w w w w w w w w w w w w w w w       w w w w w w w w w w w w w w w w                                               w                       w w 
w w w w w w w w w w w w w w w w w w w w w w w w w w w w w w w w w w       w w w w w w w w w w w w w w w w                               w w w w w       w                       w w 
w w w w w w w w w w w w w w w w w w w w w w w w w w w w w w w w w w       w w w w w w w w w w w w w w w w                               w w w w w       w                       w w 
w w w w w w w w w w w w w w w w w w w w w w w w w w w w w w w w w w       w w w w w w w w w w w w w w w w                               w w w w w       w                       w w 
w w w w w w w w w w w w w w w w w w w w w w w w w w w w w w w w w w                                                                     w w w w w                               w w 
w w w w w w w w w w w w w w w w w w w w w w w w w w w w w w w w w w                                                                     w w w w w                               w w 
w w w w w w w w w w w w w w w w w w w w w w w w w w w w w w w w w w                                                                     w w w w w                               w w 
w w w w w w w w w w w w w w w w w w w w w w w w w w w w w w w w w w w w w w w w w w w w w w w w w w w w w                               w w w w w w w w w                       w w 
w w w w w w w w w w w w w w w w w w w w w w w w w w w w w w w w w w w w w w w w w w w w w w w w w w w w w                               w w w w w w w w w                       w w 
w w w w w w w w w w w w w w w w w w w w w w w w w w w w w w w w w w w w w w w w w w w w w w w w w w w w w w w w w w w w w w w w w w w w w w w w w w w w w                       w w 
w w w w w w w w w w w w w w w w w w w w w w w w w w w w w w w w w w w w w w w w w w w w w w w w w w w w w w w w w w w w w w w w w w w w w w w w w w w w w                       w w 
w w w w w w w w w w w w w w w w w w w w w w w w w w w w w w w w w w w w w w w w w w w w w w w w w w w w w w w w w w w w w w w w w w w w w w w w w w w w w w w w w w w w w w w w w w 
