(:SIZE (90 90) 
 :TABLE (W GAME-WALL 
	 SPACE GAME-FLOOR 
	 P (PLAYER GAME-FLOOR)
	 b (bee pop-floor)
	 c (chototsu pop-floor)
	 r (red-bee pop-floor)
	 u upstairs
	 n (nuko game-floor)))
w w w w w w w w w w w w w w w w w w w w w w w w w w w w w w w w w w w w w w w w w w w w w w w w w w w w w w w w w w w w w w w w w w w w w w w w w w w w w w w w w w w w w w w w w w 
w w w w w w w w w w w w w w w w w w w w w w w w w w w w w w w w w w w w w w w w w w w w w w w w w w w w w w w w w w w w w w w w w w w w w w w w w w w w w w w w w w w w w w w w w w 
w w w w w w w w w w w w w w w w w w w w w w w w w w w w w w w w w w w w w w w w w w w w w w w w w w w w w w w w w w w w w w w w w w w w w w w w w w w w w w w w w w w w w w w w w w 
w w w w w w w w w w w w w w w w w w w w w w w w w w w w w w                                                               w w w w w w w w w w w w w w w w w w w w w w w w w w w w w 
w w w w w w w w w w w w w                                                                                                 w w w w w w w w w w w w w w w w w w w w w w w w w w w w w 
w w w w w w w w w w w w w                                                                                                 w w w w w w w w w w w w w w w w w w w w w w w w w w w w w 
w w w w w w w w w w w w w                                                                                                 w w w w w w w w w w w w w w w w w w w w w w w w w w w w w 
w w w w w w w w w w w w w       w w w w w w w w w w w w w w                                                               w w w w w w w w w w w w w w w w w w w w w w w w w w w w w 
w w w w w w w w w w w w w       w w w w w w w w w w w w w w                                           b                   w w w w w w w w w w w w w w w w w w w w w w w w w w w w w 
w w w w w w w w w w w w w       w w w w w w w w w w w w w w       c                 r                                     w w w w w w w w w w w w w w w w w w w w w w w w w w w w w 
w w w w w w w w w w w w w       w w w w w w w w w w w w w w                                                               w w w w w w w w w w w w w w w w w w w w w w w w w w w w w 
w w w w w w w w w w w w w       w w w w w w w w w w w w w w                                                               w w w w w w w w w w w w w w w w w w w w w w w w w w w w w 
w w w w w w w w w w w w w       w w w w w w w w w w w w w w                                                               w w w w w w w w w w w w w w w w w w w w w w w w w w w w w 
w w w w w w w w w w w w w       w w w w w w w w w w w w w w                                                               w w w w w w w w w w w w w w w w w w w w w w w w w w w w w 
w w w w w w w w w w w w w       w w w w w w w w w w w w w w                                                               w w w w w w w w w w w w w w w w w w w w w w w w w w w w w 
w w w w w w w w w w w w w       w w w w w w w w w w w w w w                                                               w w w w w w w w w w w w w w w w w w w w w w w w w w w w w 
w w w w w w w w w w w w w   c   w w w w w w w w w w w w w w                                                               w w w w w w w w w w w w w w w w w w w w w w w w w w w w w 
w w w w w w w w w w w w w       w w w w w w w w w w w w w w                                                               w w w w w w w w w w w w w w w w w w w w w w w w w w w w w 
w w w w w w w w w w w w w       w w w w w w w w w w w w w w                                                               w w w w w w w w w w w w w w w w w w w w w w w w w w w w w 
w w w w w w w w w w w w w       w w w w w w w w w w w w w w                                                               w w w w w w w w w w w w w w w w w w w w w w w w w w w w w 
w w w w w w w w w w w w w       w w w w w w w w w w w w w w                                                               w w w w w w w w w w w w w w w w w w w w w w w w w w w w w 
w w w w w w w w w w w w w       w w w w w w w w w w w w w w                                                   c           w w w w w w w w w w w w w w w w w w w w w w w w w w w w w 
w w w w w w w w w w w w w       w w w w w w w w w w w w w w                                                               w w w w w w w w w w w w w w w w w w w w w w w w w w w w w 
w w w                           w w w w w w w w w w w w w w           b                                                   w w w w w w w w w w w w w w w w w w w w w w w w w w w w w 
w w w                           w w w w w w w w w w w w w w                                                               w w w w w w w w w w w w w w w w w w w w w w w w w w w w w 
w w w                           w w w w w w w w w w w w w w                                                               w w w w w w w w w w w w w w w w w w w w w w w w w w w w w 
w w w                           w w w w w w w w w w w w w w                                                               w w w w w w w w w w w w w w w w w w w w w w w w w w w w w 
w w w                           w w w w w w w w w w w w w w w w w       w w w w w w       w w w w w w w w w w w w w w w w w w w w w w w w w w w w w w w w w w w w w w w w w w w w w 
w w w                 r         w w w w w w w w w w w w w w w w w       w w w w w w       w w w w w w w w w w w w w w w w w w w w w w w w w w w w w w w w w w w w w w w w w w w w w 
w w w                           w w w w w w w w w w w w w w w w w       w w w w w w       w w w w w w w w w w w w w w w w w w w w w w w w w w w w w w w w w w w w w w w w w w w w w 
w w w                           w w w w w w w w w w w w w w w w w       w w w w w w       w w w w w w w w w w w w w w w w w w w w w w w w w w w w w w w w w w w w w w w w w w w w w 
w w w                           w w w w w w                             w w w w w w                                                   w w w w w w w w w w w w w w w w w w w w w w w 
w w w                           w w w w w w                             w w w w w w                                                   w w w w w w w w w w w w w w w w w w w w w w w 
w w w                           w w w w w w                             w w w w w w                                                   w w w w w w w w w w w w w w w w w w w w w w w 
w w w                           w w w w w w       w w w w w w w w w w w w w w w w w w w w w w w w w w w w w w w w w w w w w w w       w w w w w w w w w w w w w w w w w w w w w w w 
w w w                           w w w w w w       w w w w w w w w w w w w w w w w w w w w w w w w w w w w w w w w w w w w w w w       w w w w w w w w w w w w w w w w w w w w w w w 
w w w                           w w w w w w       w w w w w w w w w w w w w w w w w w w w w w w w w w w w w w w w w w w w w w w       w w w w w w w w w w w w w w w w w w w w w w w 
w w w                           w w w w w w       w w w w w w w w w w w w w w w w w w w w w w w                                                               w w w w w w w w w w w 
w w w                           w w w w w w       w w w w w w w w w w w w w w w w w w w w w w w                                                               w w w w w w w w w w w 
w w w                           w w w w w w       w w w w w w w w w w w w w w w w w w w w w w w             b                           r                     w w w w w w w w w w w 
w w w                           w w w w w w       w w w w w w w w w                                                                                           w w w w w w w w w w w 
w w w                           w w w w w w       w w w w w w w w w                                                                                           w w w w w w w w w w w 
w w w                                                         w w w                                                                                           w w w w w w w w w w w 
w w w                                                         w w w       w w w w w w w w w w w                                                               w w w w w w w w w w w 
w w w                                                                     w w w w w w w w w w w                                                               w w w w w w w w w w w 
w w w           c               w w w                                     w w w w w w w w w w w                                                               w w w w w w w w w w w 
w w w                           w w w                                     w w w w w w w w w w w                                                     r         w w w w w w w w w w w 
w w w                           w w w                         w w w       w w w w w w w w w w w                                                               w w w w w w w w w w w 
w w w                           w w w     b                   w w w       w w w w w w w w w w w                                                               w w w w w w w w w w w 
w w w                           w w w                         w w w       w w w w w w w w w w w                                                               w w w w w w w w w w w 
w w w                       w w w w w                                     w w w w w w w w w w w           b                                                   w w w w w w w w w w w 
w w w                       w w w w w                                     w w w w w w w w w w w                                                               w w w w w w w w w w w 
w w w                       w w w w w                                     w w w w w w w w w w w w w w w w w w w w w w w w w w w w w w w w                     w w w w w w w w w w w 
w w w                       w w w w w                         w w w       w w w w w w w w w w w w w w w w w w w w w w w w w w w w w w w w                     w w w w w w w w w w w 
w w w w w w w w w w w w w w w w w w w                         w w w       w w w w w w w w w w w w w w w w w w w w w w w w w w w w w w w w                     w w w w w w w w w w w 
w w w w w w w w w w w w w w w w w w w                         w w w       w w w w w w w w w w w w w w w w w w w w w w w w w w w w w w w w w w w w w w w                           w 
w w w w w w w w w w w w w w w w w w w                         w w w       w w w w w w w w w w w w w w w w                               w w w w w w w w                           w 
w w w w w w w w w w w w w w w w w w w     u p                 w w w       w w w w w w w w w w w w w w w w                               w w w w w w w w w     c                   w 
w w w w w w w w w w w w w w w w w w w                         w w w       w w w w w w w w w w w w w w w w                               w w w w w                                 w 
w w w w w w w w w w w w w w w w w w w                         w w w       w w w w w w w w w w w w w w w w                               w w w w w                                 w 
w w w w w w w w w w w w w w w w w w w                c        w w w       w w w w w w w w w w w w w w w w                               w w w w w                                 w 
w w w w w w w w w w w w w w w w w w w                         w w w       w w w w w w w w w w w w w w w w                               w w w w w                                 w 
w w w w w w w w w w w w w w w w w w w                         w w w       w w w w w w w w w w w w w w w w                         n     w w w w w       w                         w 
w w w w w w w w w w w w w w w w w w w                         w w w       w w w w w w w w w w w w w w w w                               w w w w w       w                         w 
w w w w w w w w w w w w w w w w w w w                         w w w       w w w w w w w w w w w w w w w w                               w w w w w       w                         w 
w w w w w w w w w w w w w w w w w w w                         w w w       w w w w w w w w w w w w w w w w                               w w w w w       w                         w 
w w w w w w w w w w w w w w w w w w w                         w w w       w w w w w w w w w w w w w w w w                               w w w w w       w                         w 
w w w w w w w w w w w w w w w w w w w                         w w w       w w w w w w w w w w w w w w w w                               w w w w w       w                         w 
w w w w w w w w w w w w w w w w w w w                         w w w       w w w w w w w w w w w w w w w w                               w w w w w       w           r             w 
w w w w w w w w w w w w w w w w w w w                         w w w       w w w w w w w w w w w w w w w w                               w w w w w       w                         w 
w w w w w w w w w w w w w w w w w w w                         w w w       w w w w w w w w w w w w w w w w                               w w w w w       w                         w 
w w w w w w w w w w w w w w w w w w w                         w w w       w w w w w w w w w w w w w w w w                                               w                         w 
w w w w w w w w w w w w w w w w w w w                         w w w       w w w w w w w w w w w w w w w w                                               w                         w 
w w w w w w w w w w w w w w w w w w w                         w w w       w w w w w w w w w w w w w w w w                                               w                         w 
w w w w w w w w w w w w w w w w w w w                         w w w       w w w w w w w w w w w w w w w w                               w w w w w w w w                           w 
w w w w w w w w w w w w w w w w w w w w w w w w w       w w w w w w       w w w w w w w w w w w w w w w w                               w w w w w w w w                           w 
w w w w w w w w w w w w w w w w w w w w w w w w w       w w w w w w       w w w w w w w w w w w w w w w w                               w w w w w w w w       w w w w w w w w w w w 
w w w w w w w w w w w w w w w w w w w w w w w w w       w w w w w w       w w w w w w w w w w w w w w w w                               w w w w w w w w             w w w w w w w w 
w w w w w w w w w w w w w w w w w w w w w w w w w       w w w w w w       w w w w w w w w w w w w w w w w                                                           w w w w w w w w 
w w w w w w w w w w w w w w w w w w w w w w w w w                         w w w w w w w w w w w w w w w w                                                           w w w w w w w w 
w w w w w w w w w w w w w w w w w w w w w w w w w                         w w w w w w w w w w w w w w w w                                                                       w w 
w w w w w w w w w w w w w w w w w w w w w w w w w                         w w w w w w w w w w w w w w w w                               w w w w w       w                       w w 
w w w w w w w w w w w w w w w w w w w w w w w w w w w w w w w w w w       w w w w w w w w w w w w w w w w                               w w w w w       w                       w w 
w w w w w w w w w w w w w w w w w w w w w w w w w w w w w w w w w w       w w w w w w w w w w w w w w w w                     b         w w w w w       w                       w w 
w w w w w w w w w w w w w w w w w w w w w w w w w w w w w w w w w w                                                                     w w w w w                  r            w w 
w w w w w w w w w w w w w w w w w w w w w w w w w w w w w w w w w w                                                                     w w w w w                               w w 
w w w w w w w w w w w w w w w w w w w w w w w w w w w w w w w w w w                                                                     w w w w w                               w w 
w w w w w w w w w w w w w w w w w w w w w w w w w w w w w w w w w w w w w w w w w w w w w w w w w w w w w   c                           w w w w w w w w w                       w w 
w w w w w w w w w w w w w w w w w w w w w w w w w w w w w w w w w w w w w w w w w w w w w w w w w w w w w                               w w w w w w w w w                       w w 
w w w w w w w w w w w w w w w w w w w w w w w w w w w w w w w w w w w w w w w w w w w w w w w w w w w w w w w w w w w w w w w w w w w w w w w w w w w w w                       w w 
w w w w w w w w w w w w w w w w w w w w w w w w w w w w w w w w w w w w w w w w w w w w w w w w w w w w w w w w w w w w w w w w w w w w w w w w w w w w w                       w w 
w w w w w w w w w w w w w w w w w w w w w w w w w w w w w w w w w w w w w w w w w w w w w w w w w w w w w w w w w w w w w w w w w w w w w w w w w w w w w w w w w w w w w w w w w w 
