
(:SIZE (100 100) :TABLE
       (w GAME-WALL 
	space GAME-FLOOR
	p (player game-floor)))
w w w w w w w w w w w w w w w w w w w w w w w w w w w w w w w w w w w w w w w w w w w w w w w w w w w w w w w w w w w w w w w w w w w w w w w w w w w w w w w w w w w w w w w w w w w w w w w w w w w w 
w w w w w w w w w w w w w w w w w w w w w w w w w w w w w w w w w w w w w w w w w w w w w w w w w w w w w w w w w w w w w w w w w w w w w w w w w w w w w w w w w w w w w w w w w w w w w w w w w w w w 
w w w w w w w w w w w w w w w w w w w w w w w w w w w w w w w w w w w w w w w w w w w w w w w w w w w w w w w w w w w w w w w w w w w w w w w w w w w w w w w w w w w w w w w w w w w w w w w w w w w w 
w w w w w w w w w w w w w w w w w w w w w w w w w w w w w w w w w w w w w w w w w w w w w w w w w w w w w w w w w w w w w w w w w w w w w w w w w w w w w w w w w w w w w w w w w w w w w w w w w w w w 
w w w w w w w w w w w w w w w w w w w w w w w w w w w w w w w w w w w w w w w w w w w w w w w w w w w w w w w w w w w w w w w w w w w w w w w w w w w w w w w w w w w w w w w w w w w w w w w w w w w w 
w w w w w w w w w w w w w w w w w w w w w w w w w w w w w w w w w w w w w w w w w w w w w w w w w w w w w w w w w w w w w w w w w w w w w w w w w w w w w w w w w w w w w w w w w w w w w w w w w w w w 
w w w w w w w w w w w w w w w w w w w w w w w w w w w w w w w w w w w w w w w w w w w w w w w w w w w w w w w w w w w w w w w w w w w w w w w w w w w w w w w w w w w w w w w w w w w w w w w w w w w w 
w w w w w w w w w w w w w w w w w w w w w w w w w w w w w w w w w w w w w w w w w w w w w w w w w w w w w w w w w w w w w w w w w w w w w w w w w w w w w w w w w w w w w w w w w w w w w w w w w w w w 
w w w w w w w w w w w w w w w w w w w w w w w w w w w w w w w w w w w w w w w w w w w w w w w w w w w w w w w w w w w w w w w w w w w w w w w w w w w w w w w w w w w w w w w w w w w w w w w w w w w w 
w w w w w w w w w w w w w w w w w w w w w w w w w w w w w w w w w w w w w w w w w w w w w w w w w w w w w w w w w w w w w w w w w w w w w w w w w w w w w w w w w w w w w w w w w w w w w w w w w w w w 
w w w w w w w w w w w w w w w w w w w w w w w w w w w w w w w w w w w w w w w w w w w w w w w w w w w w w w w w w w w w w w w w w w w w w w w w w w w w w w w w w w w w w w w w w w w w w w w w w w w w 
w w w w w w w w w w w w w w w w w w w w w w w w w w w w w w w w w w w w w w w w w w w w w w w w w w w w w w w w w w w w w w w w w w w w w w w w w w w w w w w w w w w w w w w w w w w w w w w w w w w w 
w w w w w w w w w w w w w w w w w w w w w w                                                               w w w w w w w w w w w w w w w w w w w w w w w w w w w w w w w w w w w w w w w w w w w w w w w 
w w w w w w w w w w w w w w w w w w w w w w                                                               w w w w w w w w w w w w w w w w w w w w w w w w w w w w w w w w w w w w w w w w w w w w w w w 
w w w w w w w w w w w w w w w w w w w w w w                                                               w w w w w w w w w w w w w w w w w w w w w w w w w w w w w w w w w w w w w w w w w w w w w w w 
w w w w w w w w w w w w w w w w w w w w w w       p                                                       w w w w w w w w w w w w w w w w w w w w w w w w w w w w w w w w w w w w w w w w w w w w w w w 
w w w w w w w w w w w w w w w w w w w w w w                                                               w w w w w w w w w w w w w w w w w w w w w w w w w w w w w w w w w w w w w w w w w w w w w w w 
w w w w w w w w w w w w w w w w w w w w w w                                                               w w w w w w w w w w w w w w w w w w w w w w w w w w w w w w w w w w w w w w w w w w w w w w w 
w w w w w w w w w w w w w w w w w w w w w w                                                               w w w w w w w w w w w w w w w w w w w w w w w w w w w w w w w w w w w w w w w w w w w w w w w 
w w w w w w w w w w w w w w w w w w w w w w                                                               w w w w w w w w w w w w w w w w w w w w w w w w w w w w w w w w w w w w w w w w w w w w w w w 
w w w w w w w w w w w w w w w w w w w w w                                                                 w w w w w w w w w w w w w w w w w w w w w w w w w w w w w w w w w w w w w w w w w w w w w w w 
w w w w w w w w w w w w w w w w w w w w w                                                                 w w w w w w w w w w w w w w w w w w w w w w w w w w w w w w w w w w w w w w w w w w w w w w w 
w w w w w w w w w w w w w w w w w w w w w                                                                 w w w w w w w w w w w w w w w w w w w w w w w w w w w w w w w w w w w w w w w w w w w w w w w 
w w w w w w w w w w w w w w w w w w w w w                                                                 w w w w w w w w w w w w w w w w w w w w w w w w w w w w w w w w w w w w w w w w w w w w w w w 
w w w w w w w w w w w w w w w w w w w w w                                                                 w w w w w w w w w w w w w w w w w w w w w w w w w w w w w w w w w w w w w w w w w w w w w w w 
w w w w w w w w w w w w w w w w w w w w w                                                                 w w w w w w w w w w w w w w w w w w w w w w w w w w w w w w w w w w w w w w w w w w w w w w w 
w w w w w w w                       w w w                                                                 w w w w w w w w w w w w w w w w w w w w w w w w w w w w w w w w w w w w w w w w w w w w w w w 
w w w w w w w                                                                                             w w w w w w w w w w w w w w w w w w w w w w w w w w w w w w w w w w w w w w w w w w w w w w w 
w w w w w w w                       w w w w                                                               w w w w w w w w w w w w w w w w w w w w w w w w w w w w w w w w w w w w w w w w w w w w w w w 
w w w w w w w                       w w w w w w w w w w w w   w w w w w w w w w w w w   w w w w w w w w w w w w w w w w w w w w w w w w w w w w w w w w w w w w w w w w w w w w w w w w w w w w w w w w 
w w w w w w w                               w w w w w w w w   w w w w w w w w w w w w   w w w w w w w w w w w w w w w w w w w w w w w w w w w w w w w w w w w w w w w w w w w w w w w w w w w w w w w w 
w w w w w w w                       w w w   w w w w w w w w   w w w w w w w w w w w w   w w w w w w w w w w w w w w w w w w w w w w w w w w w w w w w w w w w w w w w w w w w w w w w w w w w w w w w w 
w w w w w w w                       w w w   w w w w w w w w   w w w w w w w w w w w w   w w w w w w w w w w w w w w w w w w w w w w w w w w w w w w w w w w w w w w w w w w w w w w w w w w w w w w w w 
w w w w w w w                       w w w   w w w w w w w w   w w w w w w w w w w w w   w w w w w w w w w w w w w w w w w w w w w w w w w w w w w w w w w w w w w w w w w w w w w w w w w w w w w w w w 
w w w w w w w                       w w w   w w w w w w w w   w w w w w w w w w w w w   w w w w w w w w w w w w w w w w w w w w w w w w w w w w w w w w w w w w w w w w w w w w w w w w w w w w w w w w 
w w w w w w w                       w w w   w w w w w w w w   w w w w w w w w w w w w   w w w w w w w w w w w w w w w w w w w w w w w w w w w w w w w w w w w w w w w w w w w w w w w w w w w w w w w w 
w w w w w w w                       w w w   w w w w w w w w   w w w w w w w w w w w w   w w w w w w w w w w w w w w w w w w w w w w w w w w w w w w w w w w w w w w w w w w w w w w w w w w w w w w w w 
w w w w w w w                       w w w   w w w w w w w w   w w w w w w w w w w w w   w w w w w w w w w w w w w w w w w w w w w w w w w w w w w w w w w w w w w w w w w w w w w w w w w w w w w w w w 
w w w w w w w                       w w w   w w w w w w w w   w w w w w w w w w w w w   w w w w w w w w w w w w w w w w w w w w w w w w w w w w w w w w w w w w w w w w w w w w w w w w w w w w w w w w 
w w w w w w w                       w w w   w w w w w w w w                                                                                                                         w w w w w w w w w w 
w w w w w w w                       w w w   w w w w w w w w w w w w w w w   w w w w w w w w w w w w w w w w w w w w w w w w w w w w                                                       w w w w w w w 
w w w w w w w                       w w w   w w w w w w w w w w w w w w w   w w w w w w w w w w w w w w w w w w w w w w w w w w w w                                                       w w w w w w w 
w w w w w w w                       w w w   w w w w w w w w w w w w w w w   w w w w w w w w w w w w w w w w w w w w w w w w w w w w                                                       w w w w w w w 
w w w w w w w                       w w w   w w w w w w w w w w w w w w w   w w w w w w w w w w w w w w w w w w w w w w w w w w w w                                                       w w w w w w w 
w w w w w w w                       w w w   w w w w w w w w w w w w w w w   w w w w w w w w w w w w w w w w w w w w w w w w w w w w                                                       w w w w w w w 
w w w w w w w                       w w w   w w w w w w w w w w w w w w w   w w w w w w w w w w w w w w w w w w w w w w w w w w w w                                                       w w w w w w w 
w w w w w w w                       w w w   w w w w w w w w w w w w w w w   w w w w w w w w w w w w w w w w w w w w w w w w w w w w                                                       w w w w w w w 
w w w w w w w                       w w w   w w w w w w w w w w w w w w w   w w w w w w w w w w w w w w w w w w w w w w w w w w w w                                                       w w w w w w w 
w w w w w w w                       w w w   w w w w w w w w w w w w w w w   w w w w w w w w w w w w w w w w w w w w w w w w                                                               w w w w w w w 
w w w w w w w                       w w w   w w w w w w w w w w w w w w w   w w w w w w w w w w w w w w w w w w w w w w w w   w w w                                                       w w w w w w w 
w w w w w w w                       w w w   w w w w w w w w w w w w w w w   w w w w w w w w w w w w w w w w w w w w w w w w   w w w                                                       w w w w w w w 
w w w w w w w                       w w w   w w w w w w w w w w w w w w w   w w w w w w w w w w w w w w w w w w w w w w w w   w w w w   w w w w w w w w w w w   w w w w w w w w w w w w w w w w w w w w 
w w w w w w w                       w w w   w w w w w w w w w w w w w w w   w w w w w w w w w w w w w w w w w w w w w w w w   w w w w   w w w w w w w w w w w   w w w w w w w w w w w w w w w w w w w w 
w w w w w w w                       w w w   w w w w w w w w w w w w w w w   w w w w w w w w w w w w w w w w w w w w w w w w   w w w w                                                             w w w 
w w w w w w w                       w w w   w w w w w w w w w w w w w w w   w w w w w w w w w w w w w w w w w w w w w w w w   w w w w w w   w w w w w w w w w w w w w w w                         w w w 
w w w w w w w                       w w w   w w w w w w w w w w w w w w w   w w w w w w w w w w w w w w w w w w w w w w w w   w w w w w w   w w w w w w w w w w w w w w w                         w w w 
w w w w w w w                       w w w   w w w w w w w w w w w w w w w   w w w w w w w w w w w w w w w w w w w w w w w w   w w w w w w   w w w w w w w w w w w w w w w                         w w w 
w w w w w w w w w w w w w w w w w w w w w   w w w w w w w w w w w w w w w   w w w w w w w w w w w w w w w w w w w w w w w w   w w w w w w   w w w w w w w w w w w w w w w                         w w w 
w w w w w w w w w w w w w w w w w w w w w   w w w w w w w w w w w w w w w   w w w w w w w w w w w w w w w w w w w w w w w w   w w w w w w   w w w w w w w w w w w w w w w                         w w w 
w w w w w w w w w w w w w w w w w w w w w   w w w w w w w w w w w w w w w   w w w w w w w w w w w w w w w w w w w w w w w w   w w w w w w   w w w w w w w w w w w w w w w                         w w w 
w w w w w w w w w w w w w w w w w w w w w   w w w w w w w w w w w w w w w                             w w w w w w w w w w w   w w w w w w   w w w w w w w w w w w w w w w                         w w w 
w w w w w w w w w w w w w w w w w w w w w   w w w w w w w w w w w w w w w                             w w w w w w w w w w w   w w w w w w   w w w w w w w w w w w w w w w                         w w w 
w w w w w w w w w w w w w w w w w w w w w   w w w w w w w w w w w w w w w                             w w w w w w w w w w w   w w w w w w   w w w w w w w w w w w w w w w                         w w w 
w w w w w w w w w w w w w w w w w w w w w   w w w w w w w w w w w w w w w                             w w w w w w w w w w w   w w w w w w   w w w w w w w w w w w w w w w                         w w w 
w w w w w w w w w w w w w w w w w w w w w   w w w w w w w w w w w w w w w                             w w w w w w w w w w w   w w w w w w   w w w w w w w w w w w w w w w                         w w w 
w w w w w w w w w w w w w w w w w w w w w   w w w w w w w w w w w w w w w                             w w w w w w w w w w w   w w w w w w   w w w w w w w w w w w w w w w                         w w w 
w w w w w w w w w w w w w w w w w w w w w   w w w w w w w w w w w w w w w                             w w w w w w w w w w w   w w w w w w   w w w w w w w w w w w w w w w                         w w w 
w w w w w w w w w w w w w w w w w w w w w   w w w w w w w w w w w w w w w                             w w w w w w w w w w w   w w w w w w   w w w w w w w w w w w w w w w                         w w w 
w w w w w w w w w w w w w w w w w w w w w   w w w w w w w w w w w w w w w                             w w w w w w w w w w w   w w w w w w   w w w w w w w w w w w w w w w                         w w w 
w w w w w w w w w w w w w w w w w w w w w   w w w w w w w w w w w w w w w                             w w w w w w w w w w w   w w w w w w   w w w w w w w w w w w w w w w                         w w w 
w w w w w w w w w w w w w w w w w w w w w   w w w w w w w w w w w w w w w                             w w w w w w w w w w w   w w w w w w   w w w w w w w w w w w w w w w                         w w w 
w w w w w w w w w w w w w w w w w w w w w   w w w w w w w w w w w w w w w                             w w w w w w w w w w w   w w w w w w   w w w w w w w w w w w w w w w                         w w w 
w w w w w w w w w w w w w w w w w w w w w   w w w w w w w w w w w w w w w                             w w w w w w w w w w w   w w w w w w   w w w w w w w w w w w w w w w                         w w w 
w w w w w w w w w w w w w w w w w w w w w   w w w w w w w w w w w w w w w                                                     w w w w w w   w w w w w w w w w w w w w w w                         w w w 
w w w w w w w w w w w w w w w w w w w w w   w w w w w w w w w w w w w w w                             w w w w w w w w w w w w w w w w w w   w w w w w w w w w w w w w w w   w w   w w w w w w w w w w w 
w w w w w w w w w w w w w w w w w w w w w   w w w w w w w w w w w w w w w                             w w w w w w w w w w w w w w w w w w   w w w w w w w w w w w w w w w   w w   w w w w w w w w w w w 
w w w w w w w w w w w w w w w w w w w w w   w w w w w w w w w w w w w w w                             w w w w w w w w w w w w w w w w w w   w w w w w w w w w w w w w w w   w w       w w w w w w w w w 
w w w w w w w w w w w w w w w w w w w w w   w w w w w w w w w w w w w w w                             w w w w w w w w w w w w                                   w w w w w   w w w w   w w w w w w w w w 
w w w w w w w w w w w w w w w w w w w w w   w w w w w w w w w w w w w w w                             w w w w w w w w w w w w                                   w w w w w   w w w w   w w w w w w w w w 
w w w w w w w w w w w w w w w w w w w w w   w w w w w w w w w w w w w w w                             w w w w w w w w w w w                                     w w w w w                         w w w 
w w w w w w w w w w w w w w w w w w w w w   w w w w w w w w w w w w w w w                             w w w w w w w w w w w                                     w w w w w                         w w w 
w w w w w w w w w w w w w w w w w w w w w   w w w w w w w w w w w w w w w                             w w w w w w w w w w w                                                                       w w w 
w w w w w w w w w w w w w w w w w w w w w   w w w w w w w w w w w w w w w                             w w w w w w w w w w w                                     w w w w w                         w w w 
w w w w w w w w w w w w w w w w w w w w w   w w w w w w w w w w w w w w w                             w w w w w w w w w w w                                     w w w w w                         w w w 
w w w w w w w w w w w w w w w w w w w w w   w w w w w w w w w w w w w w w                             w w w w w w w w w w w                                                                       w w w 
w w w w w w w w w w w w w w w w w w w w w   w w w w w w w w w w w w w w w                             w w w w w w w w w w w                                     w w w w w                         w w w 
w w w w w w w w w w w w w w w w w w w w w   w w w w w w w w w w w w w w w                             w w w w w w w w w w w                                     w w w w w                         w w w 
w w w w w w w w w w w w w w w w w w w w w                                                             w w w w w w w w w w w                                     w w w w w                         w w w 
w w w w w w w w w w w w w w w w w w w w w w w w w w w w w w w w w w w w w                                                                                       w w w w w                         w w w 
w w w w w w w w w w w w w w w w w w w w w w w w w w w w w w w w w w w w w                             w w w w w w w w w w w w                                   w w w w w                         w w w 
w w w w w w w w w w w w w w w w w w w w w w w w w w w w w w w w w w w w w w w w w w w w w w w w w w w w w w w w w w w w w w w w w w w w w w w w w w w w w w w w w w w w w                         w w w 
w w w w w w w w w w w w w w w w w w w w w w w w w w w w w w w w w w w w w w w w w w w w w w w w w w w w w w w w w w w w w w w w w w w w w w w w w w w w w w w w w w w w w                         w w w 
w w w w w w w w w w w w w w w w w w w w w w w w w w w w w w w w w w w w w w w w w w w w w w w w w w w w w w w w w w w w w w w w w w w w w w w w w w w w w w w w w w w w w                         w w w 
w w w w w w w w w w w w w w w w w w w w w w w w w w w w w w w w w w w w w w w w w w w w w w w w w w w w w w w w w w w w w w w w w w w w w w w w w w w w w w w w w w w w w                         w w w 
w w w w w w w w w w w w w w w w w w w w w w w w w w w w w w w w w w w w w w w w w w w w w w w w w w w w w w w w w w w w w w w w w w w w w w w w w w w w w w w w w w w w w                         w w w 
w w w w w w w w w w w w w w w w w w w w w w w w w w w w w w w w w w w w w w w w w w w w w w w w w w w w w w w w w w w w w w w w w w w w w w w w w w w w w w w w w w w w w w w w w w w w w w w w w w w w 
w w w w w w w w w w w w w w w w w w w w w w w w w w w w w w w w w w w w w w w w w w w w w w w w w w w w w w w w w w w w w w w w w w w w w w w w w w w w w w w w w w w w w w w w w w w w w w w w w w w w 
w w w w w w w w w w w w w w w w w w w w w w w w w w w w w w w w w w w w w w w w w w w w w w w w w w w w w w w w w w w w w w w w w w w w w w w w w w w w w w w w w w w w w w w w w w w w w w w w w w w w 
w w w w w w w w w w w w w w w w w w w w w w w w w w w w w w w w w w w w w w w w w w w w w w w w w w w w w w w w w w w w w w w w w w w w w w w w w w w w w w w w w w w w w w w w w w w w w w w w w w w w 
w w w w w w w w w w w w w w w w w w w w w w w w w w w w w w w w w w w w w w w w w w w w w w w w w w w w w w w w w w w w w w w w w w w w w w w w w w w w w w w w w w w w w w w w w w w w w w w w w w w w 
